0 0 0 0 0 0 0 0 0 0 0 0 0 0 0 0 0 0
0 6 2 2 7 3 9 5 6 2 2 8 10 4 9 5 8 0
0 8 9 8 8 7 10 1 10 7 1 8 2 4 4 10 4 0
0 5 9 7 7 5 9 7 7 7 9 2 10 1 4 3 4 0
0 7 2 4 6 5 5 3 10 5 6 6 5 5 2 4 10 0
0 7 1 5 7 4 8 10 6 4 9 7 9 4 3 8 5 0
0 10 4 7 2 8 5 7 2 3 10 10 3 2 1 8 3 0
0 2 5 4 9 5 5 4 4 8 4 10 3 2 1 3 9 0
0 4 9 5 6 10 1 10 5 10 10 5 6 5 9 9 5 0
0 7 3 9 7 2 7 4 1 8 9 9 3 7 3 10 10 0
0 10 2 9 10 8 7 8 3 1 7 6 1 4 8 7 7 0
0 8 7 8 10 10 1 7 9 8 9 3 6 5 5 6 6 0
0 2 4 3 3 9 4 2 3 8 8 6 6 3 9 1 6 0
0 8 3 5 3 4 5 7 1 7 7 1 7 6 2 1 9 0
0 9 5 3 7 2 7 5 2 9 3 1 2 7 7 1 7 0
0 9 6 8 4 3 10 8 10 10 8 3 2 8 3 4 5 0
0 1 6 3 4 9 4 5 4 7 8 7 10 2 7 4 10 0
0 0 0 0 0 0 0 0 0 0 0 0 0 0 0 0 0 0
