0 0 0 0 0 0 0 0 0 0 0 0 0 0 0 0 0 0
0 116 18 777 437 188 479 828 286 294 419 769 653 202 680 615 318 0
0 682 806 915 285 160 768 236 974 660 31 596 831 981 680 498 274 0
0 361 944 758 722 947 62 989 397 614 440 1 195 28 43 454 558 0
0 270 191 447 162 67 874 830 224 46 329 40 308 610 311 997 54 0
0 190 418 766 495 364 363 21 978 480 722 855 155 63 783 860 444 0
0 824 721 732 272 69 501 849 316 2 565 781 847 595 170 544 656 0
0 517 822 460 514 67 71 904 399 57 861 346 721 572 442 882 397 0
0 146 326 438 223 951 10 574 657 747 729 194 974 161 534 52 718 0
0 451 403 154 547 749 619 927 48 302 854 107 559 417 790 177 13 0
0 132 950 161 545 580 983 612 930 744 790 870 581 931 820 512 363 0
0 859 546 767 704 281 988 57 421 396 445 884 314 318 26 485 579 0
0 843 632 973 193 63 621 284 561 956 623 714 288 912 677 764 655 0
0 44 184 235 728 370 267 837 209 339 642 397 555 939 886 111 221 0
0 532 878 855 560 816 659 539 538 3 553 579 481 922 927 298 891 0
0 686 324 17 838 99 186 591 561 540 897 615 332 583 360 148 509 0
0 76 140 202 448 53 788 486 558 512 820 345 257 566 666 208 537 0
0 0 0 0 0 0 0 0 0 0 0 0 0 0 0 0 0 0
