0 0 0 0 0 0 0 0 0 0 0 0 0 0 0 0 0 0 0 0
0 -1 -16 -25 -59 -56 -85 -50 -71 -96 -9 -73 -69 -6 -29 -47 -88 -67 -94 0
0 -55 -52 -35 -77 -3 -95 -29 -32 -62 -58 -75 -12 -74 -68 -63 -77 -50 -65 0
0 -7 -63 -57 -15 -74 -23 -15 -88 -67 -18 -34 -51 -30 -96 -4 -96 -72 -93 0
0 -40 -83 -79 -5 -91 -13 -63 -27 -50 -89 0 -83 -85 -33 -90 -30 -16 -65 0
0 -59 -4 -98 -33 -93 -3 -60 -68 -69 -32 -20 -59 -34 -35 -20 -16 -60 -21 0
0 -58 -92 -55 -55 -39 -15 -51 -24 -32 -42 -64 -20 -51 -82 -55 -57 -36 -41 0
0 -11 -51 -81 -78 -81 -97 -34 -58 -20 -26 -11 -10 -62 -19 -61 -32 -37 -15 0
0 -34 -27 -16 -49 -80 -98 -87 -62 -6 -6 -60 -95 -7 -6 -24 -57 -50 -2 0
0 -30 -7 -71 -84 -77 -81 -18 -57 -17 -57 -16 -29 -44 -64 -92 -55 -52 -69 0
0 -84 -75 -10 -69 -99 -35 -89 -93 -56 -24 -82 -99 -26 -79 -93 -51 -77 -6 0
0 -69 -11 -5 -81 -20 -23 -83 -93 -92 -89 -87 -59 -2 -25 -18 -26 -69 -49 0
0 -44 -79 -77 -5 -77 -47 -29 -78 -51 -9 -86 -39 -86 -27 -34 -55 -62 -85 0
0 -4 -19 -79 -7 -12 -80 -93 -17 -93 -14 -56 -56 -57 -80 -84 -26 -53 -67 0
0 -44 -59 -76 -88 -79 -57 -77 -15 -7 -10 -2 -23 -59 -13 -86 -84 -45 -64 0
0 -90 -41 -44 -68 -26 -25 0 -60 -21 -10 -12 -36 -30 -77 -84 -59 -7 -53 0
0 -83 -65 -70 -67 -31 -48 -58 -69 -20 -88 -18 -16 -1 -26 -11 -3 -57 -18 0
0 -33 -15 -68 -83 -23 -69 -4 -15 -80 -27 -18 -17 -80 -15 -61 -18 -7 -95 0
0 -8 -85 -67 -73 -28 -56 -62 -35 -92 -61 -75 -48 -69 -9 -34 -97 -39 -46 0
0 -85 -97 -29 -93 -85 -34 -53 -83 -16 -89 -81 -47 -66 -45 -6 -25 -40 -97 0
0 -97 -42 -57 -60 -13 -81 -98 -51 -13 -97 -58 -62 -75 -17 -64 -3 -72 -34 0
0 -62 -24 -26 -54 -57 -93 -79 -44 -56 -91 -60 -73 -98 -48 -73 -9 -5 -17 0
0 -45 -39 -21 -67 -92 -67 -56 -41 -33 -67 -55 -94 -31 -61 -54 -73 -78 -68 0
0 -48 -58 -38 -71 -74 -55 -91 -41 -41 -36 -25 -58 -56 -13 -7 -87 -87 -4 0
0 -54 -66 -13 -71 -30 -73 -15 -89 -81 -63 -93 -33 -97 -56 -21 -28 -70 -66 0
0 -87 -73 -99 -36 -51 -15 -14 -86 -43 -51 -1 -99 -3 -82 -72 -74 -23 -72 0
0 -36 -99 -76 -99 -93 -85 -91 -44 -80 -79 -98 -79 -67 -89 -11 -53 -25 -85 0
0 -52 -92 -77 -2 -28 -65 -97 -57 -4 -20 -17 -63 -92 -27 -57 -90 -68 -22 0
0 -72 -68 -89 -96 -93 -43 -98 -25 -74 -66 -39 -6 -36 -6 -33 -84 -4 -76 0
0 0 0 0 0 0 0 0 0 0 0 0 0 0 0 0 0 0 0 0
